# Special countries..
REB = "countries/Rebels.txt"
PIR = "countries/Pirates.txt"
NAT = "countries/Natives.txt"

#Daimyos
AMA = "countries/Amago.txt"
ASA = "countries/Asakura.txt"
CSK = "countries/Chosokabe.txt"
DTE = "countries/Date.txt"
HJO = "countries/Hojo.txt"
HSK = "countries/Hosokawa.txt"
HTK = "countries/Hatakeyama.txt"
IKE = "countries/Ikeda.txt"
IMG = "countries/Imagawa.txt"
MAE = "countries/Maeda.txt"
MRI = "countries/Mori.txt"
ODA = "countries/Oda.txt"
OTM = "countries/Otomo.txt"
OUC = "countries/Ouchi.txt"
SBA = "countries/Shiba.txt"
SMZ = "countries/Shimazu.txt"
TKD = "countries/Takeda.txt"
TKG = "countries/Tokugawa.txt"
UES = "countries/Uesugi.txt"
YMN = "countries/Yamana.txt"
ANU = "countries/Ainu.txt"
RYU	= "countries/Ryukyu.txt"

##############################################
#       MOD TAGS
##############################################

OSZ = "countries/Oshu-Shimazu.txt"

SNB = "countries/Sannohe-Nanbu.txt"
HNB = "countries/Hachinohe-Nanbu.txt"
SSZ = "countries/Sasshu-Shimazu.txt"
ISZ = "countries/Izaku-Shimazu.txt"
HNG = "countries/Hongo.txt"
HKR = "countries/Hishikari.txt"
IRK = "countries/Iriki-in.txt"
GMO = "countries/Kamo.txt"
NJM = "countries/Nejime.txt"
KHR = "countries/Kitahara.txt"
HSZ = "countries/Hoshu-Shimazu.txt"
SNA = "countries/Sanada.txt"
HNM = "countries/Honma.txt"

NGR = "countries/Negoro.txt"
YKW = "countries/Yukawa.txt"
SZK = "countries/Saika.txt"
HUC = "countries/Horiuchi.txt"
MDR = "countries/Matsudaira.txt"
IOD = "countries/Iwakura-Oda.txt"
KOD = "countries/Kiyosu-Oda.txt"
BHY = "countries/Bishu-Hatakeyama.txt"
UMD = "countries/Umedo.txt"
SKI = "countries/Seki.txt"
HGJ = "countries/Honganji.txt"
AKI = "countries/Aki.txt"

AKJ = "countries/Anegakoji.txt"
AKZ = "countries/Akizuki.txt"
AZI = "countries/Azai.txt"
BSO = "countries/Bessho.txt"
GTO = "countries/Goto.txt"
HGN = "countries/Hagino.txt"
HNJ = "countries/Honjo.txt"
HTN = "countries/Hatano.txt"
ICJ = "countries/Ichijo.txt"
IKW = "countries/Ishikawa.txt"
IUM = "countries/Iyo-Utsunomiya.txt"
JNB = "countries/Jinbo.txt"
KGW = "countries/Kagawa.txt"
KMA = "countries/Koma.txt"
KZW = "countries/Kizawa.txt"
MIM = "countries/Mimura.txt"
MYI = "countries/Miyoshi.txt"
MKI = "countries/Miki.txt"
MNA = "countries/Matsunaga.txt"
MNK = "countries/Munakata.txt"
MST = "countries/Masuta.txt"
MTD = "countries/Matsuda.txt"
MYM = "countries/Motoyama.txt"
NGN = "countries/Nagano.txt"
NGO = "countries/Nagao.txt"
NIM = "countries/Niimi.txt"
NNJ = "countries/Nanjo.txt"
RZJ = "countries/Ryuzoji.txt"
SGH = "countries/Sugihara.txt"
SHZ = "countries/Shimizu.txt"
SHX = "countries/Sho.txt"
SNJ = "countries/Saionji.txt"
STO = "countries/Saito.txt"
SUE = "countries/Sue.txt"
TNO = "countries/Tsuno.txt"
UEN = "countries/Ueno.txt"
UKT = "countries/Ukita.txt"
URA = "countries/Urakami.txt"
YSM = "countries/Yoshimi.txt"
YTM = "countries/Yasutomi.txt"
YUC = "countries/Yamanouchi.txt"
NMK = "countries/Namioka.txt"
KAI = "countries/Kai.txt"
KIR = "countries/Kira.txt"
ATB = "countries/Atobe.txt"
HTR = "countries/Hattori.txt"
SGI = "countries/Sugi.txt"
SOD = "countries/Sagami-Oda.txt"
TGM = "countries/Tagimi.txt"
YKS = "countries/Yakushiji.txt"
YSA = "countries/Yusa.txt"
NRO = "countries/Niiro.txt"
ITO	= "countries/Ito.txt"
TNA	= "countries/Tanegashima.txt"
ASO	= "countries/Aso.txt"
KKC	= "countries/Kikuchi.txt"
SGR	= "countries/Sagara.txt"
SHN	= "countries/Shoni.txt"
UKU	= "countries/Uku.txt"
AIM	= "countries/Arima.txt"
MTA	= "countries/Matsura.txt"
OMR	= "countries/Omura.txt"
HTA	= "countries/Hata.txt"
SOO	= "countries/So.txt"
AHK	= "countries/Awa-Hosokawa.txt"
BHK	= "countries/Bitchu-Hosokawa.txt"
HYN	= "countries/Hoki-Yamana.txt"
IYN	= "countries/Inaba-Yamana.txt"
IWY	= "countries/Iwami-Yamana.txt"
AKM	= "countries/Akamatsu.txt"
ATK	= "countries/Aki-Takeda.txt"
WTK	= "countries/Wakasa-Takeda.txt"
KTK	= "countries/Kazusa-Takeda.txt"
KMK	= "countries/Kimotsuki.txt"
KNO	= "countries/Kono.txt"
KGK	= "countries/Kyogoku.txt"
OUE	= "countries/Ogigayatsu-Uesugi.txt"
EGU	= "countries/Echigo-Uesugi.txt"
TKI	= "countries/Toki.txt"
NHK = "countries/Noto-Hatakeyama.txt"
SHK = "countries/Soshu-Hatakeyama.txt"
TTI = "countries/Tsutsui.txt"
OTI = "countries/Ochi.txt"
KBK = "countries/Kitabatake.txt"
NKI = "countries/Niki.txt"
RKK = "countries/Rokkaku.txt"
KSO = "countries/Kiso.txt"
SWA = "countries/Suwa.txt"
MKM = "countries/Murakami.txt"
TNS = "countries/Takanashi.txt"
SOG = "countries/Suzuoka-Ogasawara.txt"
OGS = "countries/Ogasawara.txt"
AKY = "countries/Akiyama.txt"
TII = "countries/Toichi.txt"
HSO = "countries/Hashio.txt"
KGA = "countries/Koga-Ashikaga.txt"
ISK = "countries/Isshiki.txt"
UNO = "countries/Unno.txt"
ADO = "countries/Ando.txt"
ASN = "countries/Ashina.txt"
DHJ = "countries/Daihoji.txt"
HIE = "countries/Hienuki.txt"
IWK = "countries/Iwaki.txt"
KSI = "countries/Kasai.txt"
MNO = "countries/Minato-Ando.txt"
MGM = "countries/Mogami.txt"
NKD = "countries/Nikaido.txt"
NKH = "countries/Nikaho.txt"
NNB = "countries/Nanbu.txt"
OND = "countries/Onodera.txt"
OSB = "countries/Oshu-Shiba.txt"
OSK = "countries/Osaki.txt"
RSU = "countries/Rusu.txt"
SMA = "countries/Soma.txt"
TMA = "countries/Tamura.txt"
TZW = "countries/Tozawa.txt"
WGA = "countries/Waga.txt"
ASR = "countries/Asari.txt"
CBA = "countries/Chiba.txt"
HAK = "countries/Horigoe-Ashikaga.txt"
HIO = "countries/Hitachi-Oda.txt"
KSM = "countries/Kashima.txt"

NSU = "countries/Nasu.txt"
OAK = "countries/Oyumi-Ashikaga.txt"
OUR = "countries/Oura.txt"
SKW = "countries/Shirakawa.txt"
STK = "countries/Satake.txt"
STM = "countries/Satomi.txt"
TGS = "countries/Togashi.txt"
UMY = "countries/Utsunomiya.txt"
KKZ = "countries/Kakizaki.txt"
MRA = "countries/Miura.txt"
HAA = "countries/Hae Ainu.txt"
SSA = "countries/Shibushari Ainu.txt"
WAA = "countries/Wakkanai Ainu.txt"
